####################
#........#.........#
#.####.#.#.####.#..#
#.#  #.#.#.#  #.#..#
#.####.#.#.####.#..#
#..................#
####################
